--------------------------------------------------------------------------------------------------------------------------------------------------------------------------------------------------------
--------------------------------------------------------------------------------------------------------------------------------------------------------------------------------------------------------
--------------------------------------------------------------------------------------------------------------------------------------------------------------------------------------------------------
--------------------------------------------------------------------------------------------------------------------------------------------------------------------------------------------------------
--------------------------------------------------------------------------------------------------------------------------------------------------------------------------------------------------------
--------------------------------------------------------------------------------------------------------------------------------------------------------------------------------------------------------
--------------------------------------------------------------------------------------------------------------------------------------------------------------------------------------------------------
------------------------------------------------------------------------------------------------------------------------------------------------------------------------------------E------------------v
-------------------------------------------XX------------------------------------------------------------------------------BBBB---------------------------------------------------BBB------------------f
-----------------------------------------------------------------------------------------------------------------------------------------------------------------------------------------------EE------f
----------BB--------------B-------------------------------------------------XX------------------------BB---------------------------------BBB---BB-BBBB---------XXX-----------------------------BBB-----f
-----------------BBB-BBB------------------------------------------BBBB------------------?-----------------------------------E------------o--------------------------------BBB----E---------------------f
---------------------------BBBB---BBB------XXXXXXXT------E----BBB---------T--T---E---XXXX-----E?--------------------?---XXXXXXXX--------XXXX-----T--T---XXX-----------XXX-----EXXXXX-------------------f
----EEE------XXXXX----T-E-----?-------E-----------|XXXXXXXXXX---?-E----XXX|XX|XXXXXXX----TXXXXXXXXE-----------T--XXXXXXX--------XXXXXXXT-------E-|--|-----E---XXXXXXXX---XXXXXX------------------------f
mXXXXXXXXXXXX-----XXXX|XXXXXXXXXXXXXXXXXXXX-------|XXX-------XXXXXXXXXX---|--|-----------|XXXX----XXXXXXXXXXXX|XX---------------XXXX---|----XXXXX|XX|TXXXXXXXX-----------XX----------------------------X
XXXXXXXXXXXXXXXXXXXXXXXXXXXXXXXXXXXXXXXXXXXXXXXXXXXXXXXXXXXXXXXXXXXXXXXXXXXXXXXXXXXXXXXXXXXXXXXXXXXXXXXXXXXXXXXXXXXXXXXXXXXXXXXXXXXXXXXXXXXXXXXXXXXXXXXXXXXXXXXXXXXXXXXXXXXXXXXXXXXXXXXXXXXXXXXXXXXXXXXX
