--------------------------------------------------------------------------------------------------------------------------------------------------------------------------------------------------------
--------------------------------------------------------------------------------------------------------------------------------------------------------------------------------------------------------
--------------------------------------------------------------------------------------------------------------------------------------------------------------------------------------------------------
--------------------------------------------------------------------------------------------------------------------------------------------------------------------------------------------------------
--------------------------------------------------------------------------------------------------------------------------------------------------------------------------------------------------------
--------------------------------------------------------------------------------------------------------------------------------------------------------------------------------------------------------
--------------------------------------------------------------------------------------------------------------------------------------------------------------------------------------------------------
------------------------------------------------------------------------------------------------------------------------------------------------------------------------------------E------------------v
------------------------------------------------------------------------------XX---XX----------------------------------XXX--------------------------------------------------------BBB------------------f
---------------------------------------------------------------------------------------------------------------------------BB------------------------------------------------------------------EE------f
----------BB--------------B------------------BB---------XXX--------------------XXXX------------BBBB--------------BB----------------------------BB-BBBB---------XXX-----------------------------BBB-----f
-----------------BBB-BBB--------------------------------------------XXXX-----------E-----------------------EM--oE--------E---BB-BBBB----BBB-------------------------------BBB----E---------------------f
---------------------------BBBB---BBB--------T-------------------XX--------MXXXXXXXX--------BBBB-T---E-----XXXXXXXXXXXXXXXX-----E----------------T--T---XXX-----------XXX-----EXXXXX-------------------f
----EEE------XXXXX----T-E-----?-------E------|?-E--XXXXXXXXX?-E-T----XXXXXXX--------XXXXXXXE-----|-XXXXXXXX----------------XTXXXX----------?---E-|--|-----E---XXXXXXXX---XXXXXX------------------------f
mXXXXXXXXXXXX-----XXXX|XXXXXXXXXXXXXXXXXXXXXX|XXXXX---------XXXX|XXXX---------------XXXTXXXXXXXXX|X------------------------X|XX--XXXXXXXXXXXXXXXX|XX|TXXXXXXXX-----------XX----------------------------X
XXXXXXXXXXXXXXXXXXXXXXXXXXXXXXXXXXXXXXXXXXXXXXXXXXXXXXXXXXXXXXXXXXXXXXXXXXXXXXXXXXXXXXXXXXXXXXXXXXXXXXXXXXXXXXXXXXXXXXXXXXXXXXXXXXXXXXXXXXXXXXXXXXXXXXXXXXXXXXXXXXXXXXXXXXXXXXXXXXXXXXXXXXXXXXXXXXXXXXXX
