--------------------------------------------------------------------------------------------------------------------------------------------------------------------------------------------------------
--------------------------------------------------------------------------------------------------------------------------------------------------------------------------------------------------------
--------------------------------------------------------------------------------------------------------------------------------------------------------------------------------------------------------
--------------------------------------------------------------------------------------------------------------------------------------------------------------------------------------------------------
--------------------------------------------------------------------------------------------------------------------------------------------------------------------------------------------------------
--------------------------------------------------------------------------------------------------------------------------------------------------------------------------------------------------------
--------------------------------------------------------------------------------------------------------------------------------------------------------------------------------------------------------
------------------------------------------------------------------------------------------------------------------------------------------------------------------------------------E------------------v
------------------------------------------------------------------------------------------------------XXX-------------------------------------------------------------------------BBB------------------f
------------------------XX---XXX----------------------------BBB--BBBB----------BB--------XXXX--------------------------------------------------------------------------------------------------EE------f
-------BBB--BBBB---------------------------------------------------------------------------------------------------------BBB-------------------BB-BBBB---------XXX-----------------------------BBB-----f
---------------------------------BB-----------------------------EE--E-------BB--------E---?-----------E-E-----------XXXX--------BBBB----BBB-------------------------------BBB----E---------------------f
---------TT-----EE----------------E--------T--------T-?------M--XXXXXXXX-----------XXXXXXXXXXX-------XXXXXXXX--------------XX---E----------------T--T---XXX-----------XXX-----EXXXXX-------------------f
----E---E||-----XXTXXXXXXT-XXXXXXXXXXXE----|-------X|XXXXXXXXXXX--------XXXXXXXXXXX-----------XXXXXXX--------XXXXTXXX--E--o--E?XX----------?---E-|--|-----E---XXXXXXXX---XXXXXX------------------------f
mXXTXXXXX||XXXXX--|------|X-----------XXXXX|XXXXXXX-|-------------------XXXXXX----------------XXXXXXX--------XXXX|XXXTXXXXXXXXX--XXXXXXXXXXXXXXXX|XX|TXXXXXXXX-----------XX----------------------------X
XXXXXXXXXXXXXXXXXXXXXXXXXXXXXXXXXXXXXXXXXXXXXXXXXXXXXXXXXXXXXXXXXXXXXXXXXXXXXXXXXXXXXXXXXXXXXXXXXXXXXXXXXXXXXXXXXXXXXXXXXXXXXXXXXXXXXXXXXXXXXXXXXXXXXXXXXXXXXXXXXXXXXXXXXXXXXXXXXXXXXXXXXXXXXXXXXXXXXXXX
