--------------------------------------------------------------------------------------------------------------------------------------------------------------------------------------------------------
--------------------------------------------------------------------------------------------------------------------------------------------------------------------------------------------------------
--------------------------------------------------------------------------------------------------------------------------------------------------------------------------------------------------------
--------------------------------------------------------------------------------------------------------------------------------------------------------------------------------------------------------
--------------------------------------------------------------------------------------------------------------------------------------------------------------------------------------------------------
--------------------------------------------------------------------------------------------------------------------------------------------------------------------------------------------------------
--------------------------------------------------------------------------------------------------------------------------------------------------------------------------------------------------------
------------------------------------------------------------------------------------------------------------------------------------------------------------------------------------E------------------v
------------------------------------------------------------------------------------BBB-----------------X-------------------------------------------------------------------------BBB------------------f
------------------------------------------------------------BBB--BBBB----------------------------------------------------BBBB------------------------------------------------------------------EE------f
--------XXXX-------------------------XX--------------------------------------XXXX--------XXX---------------------------------------------------BB-BBBB---------XXX-----------------------------BBB-----f
-------------BB-------------XXXX---E------------XX--------------EE--E------E----E-o?------------------------------------EE---BB-BBBB----BBB-------------------------------BBB----E---------------------f
--T----------------------?--o----XXX------------------?------M--XXXXXXXX-XXXXXXXXXXXXXX-----------BB-T----------E----XXXXXX-----E----------------T--T---XXX-----------XXX-----EXXXXX-------------------f
--|-----E------E-T--E--XXXXXXXX--------------E--------XXXXXXXXXX--------X--------------XXXXXXXXX-E---|XXXXXXXXXXXXXXX------XTXXXX----------?---E-|--|-----E---XXXXXXXX---XXXXXX------------------------f
mX|XXXXXXXXXXXXXX|XXXXX--------XXXXTXXXXXXXXXXXXXXXXXX------------------X------T-------XXXXXXXX-XXXXX|--XXXXXXX------------X|XX--XXXXXXXXXXXXXXXX|XX|TXXXXXXXX-----------XX----------------------------X
XXXXXXXXXXXXXXXXXXXXXXXXXXXXXXXXXXXXXXXXXXXXXXXXXXXXXXXXXXXXXXXXXXXXXXXXXXXXXXXXXXXXXXXXXXXXXXXXXXXXXXXXXXXXXXXXXXXXXXXXXXXXXXXXXXXXXXXXXXXXXXXXXXXXXXXXXXXXXXXXXXXXXXXXXXXXXXXXXXXXXXXXXXXXXXXXXXXXXXXX
