--------------------------------------------------------------------------------------------------------------------------------------------------------------------------------------------------------
--------------------------------------------------------------------------------------------------------------------------------------------------------------------------------------------------------
--------------------------------------------------------------------------------------------------------------------------------------------------------------------------------------------------------
--------------------------------------------------------------------------------------------------------------------------------------------------------------------------------------------------------
--------------------------------------------------------------------------------------------------------------------------------------------------------------------------------------------------------
--------------------------------------------------------------------------------------------------------------------------------------------------------------------------------------------------------
--------------------------------------------------------------------------------------------------------------------------------------------------------------------------------------------------------
------------------------------------------------------------------------------------------------------------------------------------------------------------------------------------E------------------v
------------------------------------------------------------------------------------------------------XXX-----------------------------------------------------------------BBB-----BBB------------------f
------------------------------------------------------------BBB--BBBB----------BB--------XXXX----------------------------------------BBB-----XXX-----------------------------------------------EE------f
---------------------BBB-----XXXX-----------------------------------------------------------------------------------------------------------------------XX---XXX-XXXX--B--XX-------------------BBB-----f
-------------XXX------------------------------------------------EE--E-------BB--------E---?-----------E-E----------------------XX-BBB-BBB----------BBB--------E-----------------EE---------------------f
---------E--------BB-----------------------T--------T-?------M--XXXXXXXX-----------XXXXXXXXXXX-------XXXX---?E-------------T---E------------------------XXXXXXXXX-------XXXTXXXXXXXX-------------------f
---T-EE-XXXXXXX---T-----------o----XXXE----|-------X|XXXXXXXXXXX--------XXXXXXXXXXX-----------XXXXXXX----XXXXXT--?E-----o-X|XXXXXXXXXX----o--XXXXXXXX-o----------XXXXXX----|---------------------------f
mXX|XXXX-------XXX|XXXXXXXXXXXXXXXX---XXXXX|XXXXXXX-|-------------------XXXXXX----------------XXXXXXX----XXX--|XXXXXXXXXXX-|---------TXXXXXXX-----T--XXX---------XXXXXXX---|---------------------------X
XXXXXXXXXXXXXXXXXXXXXXXXXXXXXXXXXXXXXXXXXXXXXXXXXXXXXXXXXXXXXXXXXXXXXXXXXXXXXXXXXXXXXXXXXXXXXXXXXXXXXXXXXXXXXXXXXXXXXXXXXXXXXXXXXXXXXXXXXXXXXXXXXXXXXXXXXXXXXXXXXXXXXXXXXXXXXXXXXXXXXXXXXXXXXXXXXXXXXXXX
