--------------------------------------------------------------------------------------------------------------------------------------------------------------------------------------------------------
--------------------------------------------------------------------------------------------------------------------------------------------------------------------------------------------------------
--------------------------------------------------------------------------------------------------------------------------------------------------------------------------------------------------------
--------------------------------------------------------------------------------------------------------------------------------------------------------------------------------------------------------
--------------------------------------------------------------------------------------------------------------------------------------------------------------------------------------------------------
--------------------------------------------------------------------------------------------------------------------------------------------------------------------------------------------------------
--------------------------------------------------------------------------------------------------------------------------------------------------------------------------------------------------------
-------------------------------------------------------------------------------------------------------------------------------------------------------------------------------------------------------v
------------------------------------------------------------------------------------------------------XXX----------------------------------------------------------------------------------------------f
-----------------------------XXX----------------------------BBB--BBBB----------BB----------------------------------------BBBB--------------------------------------------------------------------------f
-----------------------------------------------------------------------------------------------------------------------------------------------BB-BBBB---------X---------------------------------------f
-----BBB-------------------------BB-----------------------------EE--E-------BB--------E------------?--------------------EE---BB-BBBB----BBB----------------------------------XXX-------EE------------E-f
---------?o------XXXX--T----------E--------T--------T-?------M--XXXXXXXX-----------XXXXX--------XXXXXXX---------E----XXXXXX-----E----------------T--T---XXX----------T---BBB----------BBB-XXXX------XX-f
---T-----XXXXXT--------|---XXXXXXXXXXXE----|-------X|XXXXXXXXXXX--------XXXXXXXXXXX-----XXXXXXXX-------XXXXXXXXXXXXXX------XTXXXX----------?---E-|--|-----E---XX-----|E----E-------X-------------------f
mXX|XXXXXTT---|XXXXXXXX|XXX-----------XXXXX|XXXXXXX-|-------------------XXXXXX----------XXXXXXX--------XXXXXXXX------------X|XX--XXXXXXXXXXXXXXXX|XX|TXXXXXXXX--XXXXX|XXXXXXXXXXXXXX-------------------X
XXXXXXXXXXXXXXXXXXXXXXXXXXXXXXXXXXXXXXXXXXXXXXXXXXXXXXXXXXXXXXXXXXXXXXXXXXXXXXXXXXXXXXXXXXXXXXXXXXXXXXXXXXXXXXXXXXXXXXXXXXXXXXXXXXXXXXXXXXXXXXXXXXXXXXXXXXXXXXXXXXXXXXXXXXXXXXXXXXXXXXXXXXXXXXXXXXXXXXXX
