--------------------------------------------------------------------------------------------------------------------------------------------------------------------------------------------------------
--------------------------------------------------------------------------------------------------------------------------------------------------------------------------------------------------------
--------------------------------------------------------------------------------------------------------------------------------------------------------------------------------------------------------
--------------------------------------------------------------------------------------------------------------------------------------------------------------------------------------------------------
--------------------------------------------------------------------------------------------------------------------------------------------------------------------------------------------------------
--------------------------------------------------------------------------------------------------------------------------------------------------------------------------------------------------------
--------------------------------------------------------------------------------------------------------------------------------------------------------------------------------------------------------
-------------------------------------------------------------------------------------------------------------------------------------------------------------------------------------------BBBB--------v
--------------------------------------------------------------------------------------------------------------------------------------------------------------------------BBB--------------------------f
-------------------------------XXX---------XX----------------------------------------------------------------------------BBBB--------------------------------------------------------------------------f
----------BB--------------B-----------------------BB-X--XXX----------------BBB---XXXX----------------------------------------------------------BB-BBBB---------XXX--------XX----------XXXX-XXXX-------Ef
-----------------BBB-BBB---------------------BB---------------------X--------------------------------XXXX-------BBB-----EE---BB-BBBB----BBB-------------------------------------E-------------------XXXf
---------------------------BB-?-----------------------T----------XX-----------------------T-----------E---------?----XXXXXX-----E----------------T--T---XXX-----------XXXXXTXXXXXXXX-------------------f
----EEE------XXXXX----T-E-----XTXXX-?--E-XXX--o-----XX|XXXXX?-E-T----Xoo---E-----------E--|-------E-XXXXXX--E---XXXXX------XTXXXX----------?---E-|--|-----E---XXXXXXXX-----|---------------------------f
mXXXXXXXXXXXX-----XXXX|XXXXXXX-|---XXXXXX---XXXXXXXX--|-----XXXX|XXXX-XXXXXXXXXXXXXXXXXXXX|XXXXXXXXX------XXXXXX-----------X|XX--XXXXXXXXXXXXXXXX|XX|TXXXXXXXX-------------|---------------------------X
XXXXXXXXXXXXXXXXXXXXXXXXXXXXXXXXXXXXXXXXXXXXXXXXXXXXXXXXXXXXXXXXXXXXXXXXXXXXXXXXXXXXXXXXXXXXXXXXXXXXXXXXXXXXXXXXXXXXXXXXXXXXXXXXXXXXXXXXXXXXXXXXXXXXXXXXXXXXXXXXXXXXXXXXXXXXXXXXXXXXXXXXXXXXXXXXXXXXXXXX
