--------------------------------------------------------------------------------------------------------------------------------------------------------------------------------------------------------
--------------------------------------------------------------------------------------------------------------------------------------------------------------------------------------------------------
--------------------------------------------------------------------------------------------------------------------------------------------------------------------------------------------------------
--------------------------------------------------------------------------------------------------------------------------------------------------------------------------------------------------------
--------------------------------------------------------------------------------------------------------------------------------------------------------------------------------------------------------
--------------------------------------------------------------------------------------------------------------------------------------------------------------------------------------------------------
--------------------------------------------------------------------------------------------------------------------------------------------------------------------------------------------------------
------------------------------------------------------------------------------------------------------------------------------------------------------------------------------------E------------------v
------------------------------------------------------------------------------------------------------XXX-------------------------------------------------------------------------BBB------------------f
-----------------------------------------------------------------------------BBBB----------------------------------------BBBB------------------------------------------------------------------EE------f
---------------------BBB-----XXXX-------------------------------BB-----------------------------------------------------------------------------BB-BBBB---------XXX-----------------------------BBB-----f
-------------XXX-----------------------------------BBB------------------XXXX-----o-----------------?--------------------EE---BB-BBBB----BBB-------------------------------BBB----E---------------------f
---------E--------BB---------------T--BBBB--------T-----E--------------?--------EXXXXXXX--------XXXXXXX---------E----XXXXXX-----E----------------T--T---XXX-----------XXX-----EXXXXX-------------------f
---T-EE-XXXXXXX---T-----------o----|-------T--o--E|EMXXXXXXX---T---?---XXXXXXXXXX-------XXXXXXXX-------XXXXXXXXXXXXXX------XTXXXX----------?---E-|--|-----E---XXXXXXXX---XXXXXX------------------------f
mXX|XXXX-------XXX|XXXXXXXXXXXXXXXX|XXXXXXX|XXXXXX|XX-------XXX|XXXXXXX-----------------XXXXXXX--------XXXXXXXX------------X|XX--XXXXXXXXXXXXXXXX|XX|TXXXXXXXX-----------XX----------------------------X
XXXXXXXXXXXXXXXXXXXXXXXXXXXXXXXXXXXXXXXXXXXXXXXXXXXXXXXXXXXXXXXXXXXXXXXXXXXXXXXXXXXXXXXXXXXXXXXXXXXXXXXXXXXXXXXXXXXXXXXXXXXXXXXXXXXXXXXXXXXXXXXXXXXXXXXXXXXXXXXXXXXXXXXXXXXXXXXXXXXXXXXXXXXXXXXXXXXXXXXX
