--------------------------------------------------------------------------------------------------------------------------------------------------------------------------------------------------------
--------------------------------------------------------------------------------------------------------------------------------------------------------------------------------------------------------
--------------------------------------------------------------------------------------------------------------------------------------------------------------------------------------------------------
--------------------------------------------------------------------------------------------------------------------------------------------------------------------------------------------------------
--------------------------------------------------------------------------------------------------------------------------------------------------------------------------------------------------------
--------------------------------------------------------------------------------------------------------------------------------------------------------------------------------------------------------
--------------------------------------------------------------------------------------------------------------------------------------------------------------------------------------------------------
------------------------------------------------------------------------------------------------------------------------------------------------------------------------------------E------------------v
------------------------------------------------------------------------------------------------------XXX-------------------------------------------------------------------------BBB------------------f
-----------------------------------------------------------------------------BBBB----------------------------------------BBBB------------------------------------------------------------------EE------f
--------XX------------------B-XX-----------------------BB--------------------------------------------------------------------------------------BB-BBBB---------XXX-----------------------------BBB-----f
---------------XXX--------BB--------BB------------------------BBB----------------o-----------------?--------------------EE---BB-BBBB----BBB-------------------------------BBB----E---------------------f
------------------T---------XXXXXXX---------T---------T--------------XXXX-------EXXXXXXX--------XXXXXXX---------E----XXXXXX-----E----------------T--T---XXX-----------XXX-----EXXXXX-------------------f
--------E-Eo-----E|----X-E---------XXXXXXXX-|---------|E?-T---EXXXXXX----X--XXXXX-------XXXXXXXX-------XXXXXXXXXXXXXX------XTXXXX----------?---E-|--|-----E---XXXXXXXX---XXXXXX------------------------f
mXXXXXXXXXXXXXXXXX|XXXXXXXXX-------XXTXXXX-X|XXXXXXXXX|XXX|XXTX-----------XX------------XXXXXXX--------XXXXXXXX------------X|XX--XXXXXXXXXXXXXXXX|XX|TXXXXXXXX-----------XX----------------------------X
XXXXXXXXXXXXXXXXXXXXXXXXXXXXXXXXXXXXXXXXXXXXXXXXXXXXXXXXXXXXXXXXXXXXXXXXXXXXXXXXXXXXXXXXXXXXXXXXXXXXXXXXXXXXXXXXXXXXXXXXXXXXXXXXXXXXXXXXXXXXXXXXXXXXXXXXXXXXXXXXXXXXXXXXXXXXXXXXXXXXXXXXXXXXXXXXXXXXXXXX
