--------------------------------------------------------------------------------------------------------------------------------------------------------------------------------------------------------
--------------------------------------------------------------------------------------------------------------------------------------------------------------------------------------------------------
--------------------------------------------------------------------------------------------------------------------------------------------------------------------------------------------------------
--------------------------------------------------------------------------------------------------------------------------------------------------------------------------------------------------------
--------------------------------------------------------------------------------------------------------------------------------------------------------------------------------------------------------
--------------------------------------------------------------------------------------------------------------------------------------------------------------------------------------------------------
--------------------------------------------------------------------------------------------------------------------------------------------------------------------------------------------------------
------------------------------------------------------------------------------------------------------------------------------------------------------------------------------------E------------------v
----------------------------------------------------------------------------------------------------------------------------------------------------------------------------------BBB------------------f
----------------------------------------------------------------------------------------------------XXXX-----------------BBBB-----------------------------------------------------------------------o--f
---------------------BBB-----XXXX----------------------------------BBBB-----------------XX-----------------------------------------------------BB-BBBB---------XXX----------------------------------XXXf
-------------XXX-----------------------------------BBB------------------------------------------------------------------EE---BB-BBBB----BBB-------------------------------BBB----E---------------------f
---------E--------BB---------------T--BBBB--------T-----E--------------------XXXX------Eo-----------E--?--T-EXX-E----XXXXXX-----E----------------T--T---XXX-----------XXX-----EXXXXX-------------------f
---T-EE-XXXXXXX---T-----------o----|-------T--o--E|EMXXXXXXX-------M----------TE-----M-XXXXXX------XXXXXXX|XX--XXXXXX------XTXXXX----------?---E-|--|-----E---XXXXXXXX---XXXXXX------------------------f
mXX|XXXX-------XXX|XXXXXXXXXXXXXXXX|XXXXXXX|XXXXXX|XX-------XXXXXXXXXXXXXXXXXX|XXXXXXXX------XXXXXX-------|----------------X|XX--XXXXXXXXXXXXXXXX|XX|TXXXXXXXX-----------XX----------------------------X
XXXXXXXXXXXXXXXXXXXXXXXXXXXXXXXXXXXXXXXXXXXXXXXXXXXXXXXXXXXXXXXXXXXXXXXXXXXXXXXXXXXXXXXXXXXXXXXXXXXXXXXXXXXXXXXXXXXXXXXXXXXXXXXXXXXXXXXXXXXXXXXXXXXXXXXXXXXXXXXXXXXXXXXXXXXXXXXXXXXXXXXXXXXXXXXXXXXXXXXX
