--------------------------------------------------------------------------------------------------------------------------------------------------------------------------------------------------------
--------------------------------------------------------------------------------------------------------------------------------------------------------------------------------------------------------
--------------------------------------------------------------------------------------------------------------------------------------------------------------------------------------------------------
--------------------------------------------------------------------------------------------------------------------------------------------------------------------------------------------------------
--------------------------------------------------------------------------------------------------------------------------------------------------------------------------------------------------------
--------------------------------------------------------------------------------------------------------------------------------------------------------------------------------------------------------
--------------------------------------------------------------------------------------------------------------------------------------------------------------------------------------------------------
-------------------------------------------------------------------------------------------------------------------------------------------------------------------------------------------------------v
-----------------M---------------?-------?-------oo-------------------------M---------------------o-----------------M-------------------------------o-----------?----M----------------o--M-------------f
-------------------o-------------o------------------------------o--------------------------------------------o-M-----------M-----------------------M---o-------------------o?------------o-------------f
------------------------------------------------M----o---o-XXXX------XXXXMX---------------XXXX---------------------o--------------------------M----------------------o----------XXXXXXXXXXX------------f
-----------T-o------oXXXX---o-----------o--T----o-------M------XXXXXX--XXXXXXXXMM--------------T-------o-----------------o-o------------------------------T-----------------------M--------------------f
-----------|XXXXXX------X--------------X--?|-XXXXTX--------X-------------T?--------------------|---X-----------------------o------------------------------|XXX-----X--------X-----------?----T---------f
----------X|-----------XX----------X--XT---|XX---|--------XX---X---------|----X------------T---|--XXX----------------X-----T------------------X-----------|-------XX-------XX--------T-------|---------f
m--------XX|----------XXX---E---E-XX-XX|---|XX--E|-------XXX--XX---------|---XX-----E------|---|EXXXX--E------------XX-----|-----------------XX-E------E--|------XXX------XXX--------|-E-----|---------X
XXXXXXXX--XX---XXXXXXXXXXXX--XXXXXXXXXXXXXXXXXXXXXXXXX--XXXXXXXXXXXXXXXXXXXXXXXXX--XXXXXXXXXXXXXXXXXXXXXXXXXXXXXXXXXXXXXXXXXXXXXX---XXXXXXXXXXXXXXXX---XXXXXXXXXXXXXXXXXXXXXXXX--XX--XXXXXXXXXXXXXXXXXXX
